720
 _________
| | |____ |
| |___    |
|  _  | |_|
| | | |   |
|S|_____|_|
